{
  "A": "打招呼",
  "B": "熱點切入",
  "C": "基本真相",
  "D": "勸退", 
  "F": "給化名",
  "G": "結束語",
  "ALL": "全部"
}
